19
#################################
#                              ##
#     @                        ##
#----------  -------------   --##
#     +              +         ##
#                      %       ##
#   ---------------  --   -----##
#     +                    - --##
#  %            +          +   ##
#---------------------   ------##
#                              ##
#       +       %              ##
#            ------------      ##
#                      +       ##
#   ------------               ##
#                       -------##
#    %      +                  ##
#                              ##
#################################