19
#################################
#                              ##
#     @ +                      ##
#----------  -------------   --##
#     +                        ##
#                      %       ##
#-  ---------------  --   -----##
#     +                    - --##
#                          +   ##
#---------------------   ------##
#                              ##
#       +       %              ##
#            ------------      ##
#                      +       ##
#   ------------               ##
#                       -------##
#    %      +                  ##
#                              ##
#################################