19
#################################
#   @                          ##
#                         %    ##
#----------  -------------   --##
#     +                        ##
#                    +         ##
#-  ---------------  --   -----##
#     +          +         - --##
#               %              ##
#---------------------   ------##
#                              ##
#                              ##
#   -------------  +           ##
#                              ##
#                      %       ##
#      +         ------------- ##
#     -------------            ##
#                              ##
#################################